0000000000616361616161616163610000000000
0000000061644143414141414341646100000000
0000000063414151515151515141416300000000
0000000061415151313131315151416100000000
0000000061435131317171313151436100000000
6153615164415131317171313151416451615361
5143514164415131317171313151416441514351
0000000061435131317171313151436100000000
0000000061415151313131315151416100000000
0000000063414151515151515141416300000000
0000000061644143414141414341646100000000
0000000000616361616161616163610000000000
Backgrounds/background2.png
