0000000000000000000000000000000000000000
0000000000000000000000000000000000000000
0000000000000000000000000000000000000000
0000000000616161616161616161610000000000
0000000061610000000000000000616100000000
0000000061000051515151515100006100000000
0000000061005151000000005151006100000000
0000000061005100000000000051006100000000
0000000061005100000000000051006100000000
0000000061005100000000000051006100000000
0000000061005100000000000051006100000000
0000000061005151000000005151006100000000
0000000061000051515151515100006100000000
0000000061610000000000000000616100000000
0000000000616161616161616161610000000000
0000000000000000000000000000000000000000
0000000000000000000000000000000000000000
0000000000000000000000000000000000000000
Backgrounds/background2.png
